Does	O
doubling	O
the	O
\	O
work	O
?	O
insert	B
into	B
EscapeTest	B
(	B
text	I
)	I
values	B
(	B
'This	I
will	B
be	B
inserted	B
\\n	B
This	B
will	B
not	B
